111111111111111111111111111111
100000000100000100000000000001
100000000100200100000000000001
100000000100000100000000000001
100000000100000100000000000001
100000000111011111110011111111
100000000001010000000000000001
100000000001010000000000000001
100000000001010000000000000001
100000000001010000000000000001
100000000001010000000000000001
100000000000000000000000000001
100000000001010000000000000001
111111111111011111111111111111
100000000001010000000000000001
100000000001010000000000000001
100000000001010000000000000001
100000000000000000000000000001
100000000001010000000000000001
111111111111011111111111111111
100000000000000000000000000001
100000000000000000000000000001
100000000000000000000000000001
100000000000000000000000000001
100000000000000000000000000001
100000000000000000000000000001
100000000000000000000000000001
100000000000000000000000000001
100000000000000000000000000001
111111111111111111111111111111